1111111
10CP001
111E111
1111111