11111111
100P0C01
10000001
10010001
10C100E1
11111111