111111111
100000001
10P000001
1000000C1
111E11001
111111111