111111111
100111111
11P001111
11E001111
111101111
111101111
111C00011
111000011
111000011
111C0C011
111C00011
1110C0C11