11111111
10000C01
1000000
1001P001
10C100E1
11111111