11111111111111
10000000000001
